#################################################
#......#...........#................#...........#
#.....##.######.###########.###.#.#...#########.#
#.#####...#........#..........#.#.#####...#.....#
#.........#.#####..#.##########.#.#...#.#.#..#..#
#.#####.###.#........#..........#.#.#...#....#..#
#..#..#.....#..#######.######.###...##########.##
#..#..#######......#...#..........#...#.........#
#..#........####.###.###...#########..#.#########
#..#..#..#..#..#...........#....#..#..#.........#
#..#..####..#....###.#.....#....#..########.#####
#..#..#..#..####...#.#.....#....#..#..#.........#
#..#..#..#.....#####.##########.#.....#.#...#####
#.......##..#......................#....#.......#
#################################################
